1111111111111111
1CCCCC100CC0P001
1000000000001011
1001110000000001
100E0C0111000001
10011111C1000001
1000000001100001
1000C00000100001
1000000000110011
10000C00001C0001
100000000C100001
1000000C00000001
1111111111111111
