1111111111111111
1CCCCC100CCCP001
1000000000000001
1001110000000001
1001000111000001
1001111101000001
1000000001100001
1000C00000100001
1000000000110011
10E00C00001C0001
100000000C100001
1000000C00000001
1111111111111111
